[
    {
        "id":1,
        "name": "Tutorial 1",
        "clicks" : 1,
        "data":[
            [0,0,0,0,0,0,0,0,0,0,0,0],
            [0,0,0,0,0,0,0,0,0,0,0,0],
            [0,0,0,0,0,0,0,0,0,0,0,0],
            [0,0,0,1,1,1,1,1,1,0,0,0],
            [0,0,0,1,1,1,1,1,1,0,0,0],
            [0,0,0,1,1,1,1,1,1,0,0,0],
            [0,0,0,1,1,1,1,1,1,0,0,0],
            [0,0,0,1,1,1,1,1,1,0,0,0],
            [0,0,0,1,1,1,1,1,1,0,0,0],
            [0,0,0,0,0,0,0,0,0,0,0,0],
            [0,0,0,0,0,0,0,0,0,0,0,0],
            [0,0,0,0,0,0,0,0,0,0,0,0]
        ]
    },

    {
        "id":2,
        "name": "Tutorial 2",
        "clicks" : 2,
        "data":[
            [0,0,0,0,0,0,0,0,0,0,0,0],
            [0,1,1,1,1,1,1,1,1,1,1,0],
            [0,1,1,1,1,1,1,1,1,1,1,0],
            [0,1,1,0,0,0,0,0,0,1,1,0],
            [0,1,1,0,0,0,0,0,0,1,1,0],
            [0,1,1,0,0,0,0,0,0,1,1,0],
            [0,1,1,0,0,0,0,0,0,1,1,0],
            [0,1,1,0,0,0,0,0,0,1,1,0],
            [0,1,1,0,0,0,0,0,0,1,1,0],
            [0,1,1,1,1,1,1,1,1,1,1,0],
            [0,1,1,1,1,1,1,1,1,1,1,0],
            [0,0,0,0,0,0,0,0,0,0,0,0]
        ]
    },

    {
        "id":3,
        "name": "Tutorial 3",
        "clicks" : 3,
        "data":[
            [0,0,0,0,0,0,0,0,0,0,0,0],
            [0,1,1,1,1,1,1,1,1,1,0,0],
            [0,1,0,0,0,0,0,0,0,0,1,0],
            [0,1,0,0,0,0,0,0,0,0,1,0],
            [0,1,0,0,0,0,0,0,0,0,1,0],
            [0,1,0,0,0,0,0,0,0,0,1,0],
            [0,1,0,0,0,0,0,0,0,0,1,0],
            [0,1,0,0,0,0,0,0,0,0,1,0],
            [0,1,0,0,0,0,0,0,0,0,1,0],
            [0,1,0,0,0,0,0,0,0,0,1,0],
            [0,0,1,1,1,1,1,1,1,1,1,0],
            [0,0,0,0,0,0,0,0,0,0,0,0]
        ]
    },

    {
        "id":4,
        "name": "Beginner 1",
        "clicks" : 4,
        "data":[
            [1,1,1,1,1,1,0,0,0,0,0,0],
            [1,1,1,1,1,1,0,0,0,0,0,0],
            [1,1,1,1,1,1,0,0,0,0,0,0],
            [1,1,1,0,0,0,1,1,1,0,0,0],
            [1,1,1,0,1,1,0,0,1,0,0,0],
            [1,1,1,0,1,1,0,0,1,0,0,0],
            [0,0,0,1,0,0,1,1,0,1,1,1],
            [0,0,0,1,0,0,1,1,0,1,1,1],
            [0,0,0,1,1,1,0,0,0,1,1,1],
            [0,0,0,0,0,0,1,1,1,1,1,1],
            [0,0,0,0,0,0,1,1,1,1,1,1],
            [0,0,0,0,0,0,1,1,1,1,1,1]
        ]
    },

    {
        "id":5,
        "name": "Beginner 2",
        "clicks" : 5,
        "data":[
            [1,1,1,1,1,0,0,1,1,1,1,1],
            [1,0,0,0,0,1,1,0,0,0,0,1],
            [1,0,0,0,0,1,1,0,0,0,0,1],
            [1,0,0,0,0,1,1,0,0,0,0,1],
            [1,0,0,0,0,1,1,0,0,0,0,1],
            [0,1,1,1,1,1,1,1,1,1,1,0],
            [0,1,1,1,1,1,1,1,1,1,1,0],
            [1,0,0,0,0,1,1,0,0,0,0,1],
            [1,0,0,0,0,1,1,0,0,0,0,1],
            [1,0,0,0,0,1,1,0,0,0,0,1],
            [1,0,0,0,0,1,1,0,0,0,0,1],
            [1,1,1,1,1,0,0,1,1,1,1,1]
        ]
    },

    {
        "id":6,
        "name": "Beginner 3",
        "clicks" : 5,
        "data":[
            [0,0,0,1,1,1,1,1,1,0,0,0],
            [0,0,0,1,1,1,1,1,1,0,0,0],
            [0,0,0,1,1,1,1,1,1,0,0,0],
            [1,1,1,0,0,0,0,0,0,1,1,1],
            [1,1,1,0,1,1,1,1,0,1,1,1],
            [1,1,1,0,1,1,1,1,0,1,1,1],
            [1,1,1,0,1,1,1,1,0,1,1,1],
            [1,1,1,0,1,1,1,1,0,1,1,1],
            [1,1,1,0,0,0,0,0,0,1,1,1],
            [0,0,0,1,1,1,1,1,1,0,0,0],
            [0,0,0,1,1,1,1,1,1,0,0,0],
            [0,0,0,1,1,1,1,1,1,0,0,0]
        ]
    },


{
        "id":7,
        "name": "Beginner 4",
        "clicks" : 6,
        "data":[
            [1,1,1,1,1,0,1,1,1,1,1,1],
            [1,0,0,0,0,1,0,0,0,0,0,1],
            [1,0,0,0,0,1,0,0,0,0,0,1],
            [1,0,0,1,1,0,1,1,1,0,0,1],
            [1,0,0,1,1,0,1,1,1,0,0,1],
            [0,1,1,0,0,0,1,1,1,0,0,1],
            [1,0,0,1,1,1,0,0,0,1,1,0],
            [1,0,0,1,1,1,0,1,1,0,0,1],
            [1,0,0,1,1,1,0,1,1,0,0,1],
            [1,0,0,0,0,0,1,0,0,0,0,1],
            [1,0,0,0,0,0,1,0,0,0,0,1],
            [1,1,1,1,1,1,0,1,1,1,1,1]
        ]
    },

    {
        "id":8,
        "name": "Beginner 5",
        "clicks" : 10,
        "data":[
            [0,0,0,1,1,1,1,1,1,0,0,0],
            [0,1,1,0,0,0,0,0,0,1,1,0],
            [0,1,0,1,1,1,1,1,1,0,1,0],
            [1,0,1,0,0,0,0,0,0,1,0,1],
            [1,0,1,0,1,1,1,1,0,1,0,1],
            [1,0,1,0,1,0,0,1,0,1,0,1],
            [1,0,1,0,1,0,0,1,0,1,0,1],
            [1,0,1,0,1,1,1,1,0,1,0,1],
            [1,0,1,0,0,0,0,0,0,1,0,1],
            [0,1,0,1,1,1,1,1,1,0,1,0],
            [0,1,1,0,0,0,0,0,0,1,1,0],
            [0,0,0,1,1,1,1,1,1,0,0,0]
        ]
    },

    {
        "id":9,
        "name": "Master 1",
        "clicks" : 8,
        "data":[
            [0,0,0,0,0,0,0,0,0,0,0,0],
            [0,0,0,0,0,1,1,0,0,0,0,0],
            [0,0,1,1,1,0,0,1,1,1,0,0],
            [0,0,1,0,0,1,1,0,0,1,0,0],
            [0,0,1,0,1,0,0,1,0,1,0,0],
            [0,1,0,1,0,0,0,0,1,0,1,0],
            [0,1,0,1,0,0,0,0,1,0,1,0],
            [0,0,1,0,1,0,0,1,0,1,0,0],
            [0,0,1,0,0,1,1,0,0,1,0,0],
            [0,0,1,1,1,0,0,1,1,1,0,0],
            [0,0,0,0,0,1,1,0,0,0,0,0],
            [0,0,0,0,0,0,0,0,0,0,0,0]
        ]
    },

    {
        "id":10,
        "name": "Master 2",
        "clicks" : 8,
        "data":[
            [0,0,0,1,1,1,1,1,1,1,0,0],
            [0,0,0,1,1,1,1,1,1,1,0,0],
            [0,0,0,1,1,1,1,1,1,1,0,0],
            [1,1,1,0,0,0,0,0,0,0,1,1],
            [1,1,1,0,0,0,0,0,0,0,1,1],
            [1,1,1,1,1,1,1,1,1,1,1,1],
            [1,1,1,1,1,1,1,1,1,1,1,1],
            [1,1,1,0,0,0,0,0,0,0,1,1],
            [1,1,1,0,0,0,0,0,0,0,1,1],
            [0,0,0,1,1,1,1,1,1,1,0,0],
            [0,0,0,1,1,1,1,1,1,1,0,0],
            [0,0,0,1,1,1,1,1,1,1,0,0]
        ]
    },

    {
        "id":11,
        "name": "Master 3",
        "clicks" : 14,
        "data":[
            [0,0,0,0,1,0,0,1,0,0,0,0],
            [0,1,1,1,0,1,1,0,1,1,1,0],
            [0,1,1,1,0,1,1,0,1,1,1,0],
            [0,1,1,0,1,0,0,1,0,1,1,0],
            [1,0,0,1,0,1,1,0,1,0,0,1],
            [0,1,1,0,1,0,0,1,0,1,1,0],
            [0,1,1,0,1,0,0,1,0,1,1,0],
            [1,0,0,1,0,1,1,0,1,0,0,1],
            [0,1,1,0,1,0,0,1,0,1,1,0],
            [0,1,1,1,0,1,1,0,1,1,1,0],
            [0,1,1,1,0,1,1,0,1,1,1,0],
            [0,0,0,0,1,0,0,1,0,0,0,0]
        ]
    },
 
    {
        "id":12,
        "name": "Master 1",
        "clicks" : 13,
        "data":[
            [1,1,1,1,1,0,1,1,1,1,1,1],
            [1,1,1,1,1,1,1,1,1,1,1,1],
            [1,1,1,1,1,1,1,1,1,1,1,1],
            [1,1,1,1,1,1,1,1,1,1,1,1],
            [1,1,1,1,1,1,1,1,1,1,1,1],
            [0,1,1,1,1,1,1,1,1,1,1,1],
            [1,1,1,1,1,1,1,1,1,1,1,0],
            [1,1,1,1,1,1,1,1,1,1,1,1],
            [1,1,1,1,1,1,1,1,1,1,1,1],
            [1,1,1,1,1,1,1,1,1,1,1,1],
            [1,1,1,1,1,1,1,1,1,1,1,1],
            [1,1,1,1,1,1,0,1,1,1,1,1]
        ]
    }
]
